#######
#W   C#
#  ## #
#    G#
#C   P#
#######
