###################
#W            #  P#
#       ###C# ### #
#   # #   #C#  C G#
# # ### # ### ### #
# #C        C   # #
# ### ### ### # # #
#   #      #  #   #
# # ### # ##  ### #
#G#               #
# ### # # ### # # #
#  CC   #     #   #
###################