####################
#    #        # C  #
#W## # ##  ## # ## #
# #     #  #     # #
# # ## ##  ## ## # #
#          #  #    #
###    ###### #  # #
#C#    #    # #  # #
# #    # ####      #
# #                #
# ## # ####### ### #
#    # #P          #
####################
