##################P#
#C           CC#   #
#C##C##C##C##C## # #
#        W   C   # #
################## #
#CCCCC       C     #
####################
