###############
#W   C       G#
# ### ### ### #
#           C #
# ### ### ### #
#   C         #
# ### ### ### #
#G          P #
###############