###############################
W   # # # #   #       # #     #
# # # # # ### # ####### # # ###
# #   #     # #   # #     #   #
### ####### # ### # ### ### # #
#   #       # #         #   # #
# # ### ##### ##### ### # #####
# # #     #   #P#   #   #     #
# # # ### ### # # #############
# #   #       #         #     #
### ##### # ##### # ##### #####
#   #     # #     #   #   #   #
##### ############### # ### # #
#           #         #     # #
# ####### ##### ### # # # ### #
#   #       # #   # #   # # # #
##### ### # # # ########### # #
#     #   # #   #     #   # # #
# ######### # # ### # # ### # #
# #   #     # # #   #         #
# ### ### # # ### # ### ### # #
#     #   #     # # #   #   # #
###############################