#########
#       #
# #     #
# #     #
# #     #
# #     #
# # #   #
# # ##P #
#W      #
#LLLLLLL#
#########
