#########
#      P#
# L     #
#       #
#W     L#
#      L#
#########
